NO textures/N_wall.xpm
SO textures/S_wall.xpm
WE textures/W_wall.xpm
EA textures/E_wall.xpm

F 220,100,1
C 225,30,80


111111111111111011111111111111
111111111000100000000000011111
100000000000000000111000100001
110000100000000000000000001111
100001111111000000000000111111
1111111000000000W0000000000001
110000000000000000000000000111
110000000000011110000000000011
100000000000111000000000000011
110000000000111000000000001111
110000000001111000000000000111
11111111111111111111111111111
