NO textures/N_wall.xpm
SO textures/S_wall.xpm
WE textures/W_wall.xpm
EA textures/E_wall.xpm


F 220,100,1
C 225,30,0



 11111111111 11111
11000100001111000111111
 1000000000001101101111
1100E000000000000000001
11000000000000000000001
11000000000000000000011
10000001111111111111111
100110001
101110001
100010001
111 11111
