NO slkdfj.xpm
SO ../textures/test.xpm
WE ../textures/test.xpm
EA .xpm

F 0,0,
C 225,30,0

 1111111
11000101
10100011
10100001
1E000001
11111001
111 111111
