NO slkdfj.xpm
SO ../textures/test.xpm
WE ../textures/test.xpm
EA d.xdm

F 01,0,0
C 225,030,011

 1111111
11000101
10100011
10100001
1E000001
11111001
111 111111
