NO d.xpm
SO ../textures/test.xpm
WE ../textures/test.xpm
EA d.xpm

F 0,0,0
C 22,30,8

 1111111
11000101
1000011
111111111

11111111
11000011
100E0001
10111001
111 111111
