NO d.xpm
SO ../textures/test.xpm
WE ../textures/test.xpm
EA d.xdm

F 0,0,255
C 22,30,255

 1111111
11000101
10100011
10100001
1E000001
11111001
111 111111
