NO textures/N_wall.xpm
SO textures/S_wall.xpm
WE textures/W_wall.xpm
EA textures/E_wall.xpm

F 220,130,0
C 10,90,150

 1111111
 1000101
1000011
 1000001
100E0001
10010001
111 111111
