NO textures/N_wall.xpm
SO textures/S_wall.xpm
WE textures/W_wall.xpm
EA textures/E_wall.xpm

F 220,100,1
C 225,30,80


1111
1001
1001
1N01
1111
